9 1 1 1 1 1 1 1 1 11 3 3 3 3 3 3 3 3 3 3 3 3 3 3 3 3 3 3
9 5 5 5 5 5 5 5 5 11 3 3 3 3 3 3 3 3 3 3 3 3 3 3 3 3 3 3
9 5 5 5 5 5 5 5 5 11 3 3 3 3 3 3 3 3 3 3 3 3 3 3 3 3 3 3
9 5 5 5 5 5 5 5 5 11 3 3 3 3 3 3 3 3 3 3 3 3 3 3 3 3 3 3
9 5 5 5 5 5 5 5 5 11 3 3 3 3 3 3 3 3 3 3 3 3 3 3 3 3 3 3
9 5 5 5 5 5 5 5 5 11 3 3 3 3 3 3 3 3 3 3 3 3 3 3 3 3 3 3
9 5 5 5 5 5 5 5 5 11 3 3 3 3 3 3 3 3 3 3 3 3 3 3 3 3 3 3
9 5 5 5 5 5 5 5 5 17 15 15 15 15 15 15 15 15 15 15 15 15 15 15 15 15 15 11
9 5 5 5 5 5 5 5 5 13 12 12 12 12 12 12 12 12 12 12 12 12 12 12 5 12 12 11
9 5 5 5 5 5 5 5 5 5 5 5 5 5 5 5 5 5 5 5 5 5 5 5 5 5 5 11
9 5 5 5 5 5 5 5 5 5 5 5 5 5 5 5 5 5 5 5 5 5 5 5 5 5 5 11
9 5 5 5 5 5 5 5 5 5 5 5 5 5 5 5 5 5 5 5 5 5 5 5 5 5 5 11
9 5 5 5 5 5 5 5 5 5 5 5 5 5 5 5 5 5 5 5 5 5 5 5 5 5 5 11
7 10 10 10 10 10 10 10 10 10 10 10 10 10 10 10 10 10 10 10 10 10 10 10 3 10 10 8 



