9 15 15 15 15 15 15 15 15 15 15 15 15 15 15 15 15 15 11
9 20 20 20 20 20 20 20 20 20 20 20 20 20 20 20 20 20 11
9 12 12 12 12 12 12 12 12 12 12 12 12 12 12 12 12 12 11
9 5 5 5 5 5 5 5 5 5 5 5 5 5 5 5 5 5 11
9 5 5 5 5 5 5 5 5 5 5 5 5 5 5 5 5 5 11
9 5 5 5 5 5 5 5 5 5 5 5 5 5 5 5 5 5 11
9 5 5 5 5 5 5 5 5 5 5 5 5 5 5 5 5 5 11
9 5 5 5 5 5 5 5 5 5 5 5 5 5 5 5 5 5 11
9 5 5 5 5 5 5 5 5 5 5 5 5 5 5 5 5 5 11
7 10 10 10 10 10 10 10 10 10 10 10 10 10 10 3 10 10 8