4 4 4 4 4 4 4 4 4 4 4 4 4 4 4 4
4 0 0 0 0 0 0 0 0 0 0 0 0 0 0 4
4 0 0 0 0 1 1 1 1 1 1 1 1 1 0 4
4 0 0 0 0 1 5 5 5 5 5 5 5 1 0 4
4 0 2 2 0 1 5 5 5 5 5 5 5 1 0 4
4 0 2 2 0 1 5 5 5 5 5 5 5 1 0 4
4 0 2 2 0 1 5 5 5 5 5 5 5 1 0 4
4 0 0 0 0 1 5 5 5 5 5 5 5 1 0 4
4 0 0 0 0 1 1 1 1 5 1 1 1 1 0 4
4 0 0 0 0 0 0 0 0 0 0 0 0 0 0 4
4 0 0 0 0 0 0 0 0 0 0 0 0 0 0 4
4 4 4 4 4 4 4 4 4 4 4 4 4 0 4 4